#1a
[[[1,1,0,0,2,1,1,18],[0,1,1,0,2,1,1,18],[1,1,0,0,2,1,1,18],[0,1,0,0,2,1,1,18],[0,1,0,1,2,1,1,18],[0,1,0,0,2,1,1,18],[0,1,0,0,2,1,1,18],[0,1,0,0,2,1,1,18]],
[[1,0,0,0,2,1,1,18],[0,0,0,1,2,1,1,18],[0,0,0,0,2,1,1,18],[0,0,1,0,2,1,1,18],[1,1,0,0,2,1,1,09],[0,0,0,0,2,1,1,18],[0,0,0,0,2,1,1,18],[0,0,0,0,2,1,1,18]],
[[1,0,0,0,2,1,1,18],[0,1,1,0,2,1,1,14],[1,0,0,0,2,1,1,18],[0,0,0,0,2,1,1,18],[0,0,0,0,2,1,1,18],[0,0,0,0,2,1,1,18],[0,0,0,0,2,1,1,18],[0,0,0,0,2,1,1,18]],
[[1,0,0,0,2,1,1,18],[0,0,0,0,2,1,1,18],[0,0,0,0,2,1,1,18],[0,0,0,0,2,1,1,18],[0,0,0,0,2,1,1,18],[0,0,0,0,2,1,1,18],[0,0,1,1,2,1,1,03],[1,0,0,0,2,1,1,18]],
[[1,0,0,0,2,1,1,18],[0,0,0,0,2,1,1,18],[0,0,0,0,2,1,1,18],[0,0,0,0,2,1,1,18],[0,0,0,0,2,1,1,18],[0,0,0,0,2,1,1,18],[0,1,0,0,2,1,1,18],[0,0,0,0,2,1,1,18]],
[[1,0,0,1,2,1,1,18],[0,0,0,0,2,1,1,18],[0,0,0,0,2,1,1,18],[0,0,0,0,2,1,1,18],[0,0,0,0,2,1,1,18],[0,0,0,0,2,1,1,18],[0,0,0,0,2,1,1,18],[0,0,0,0,2,1,1,18]],
[[1,1,0,0,2,1,1,18],[0,0,0,0,2,1,1,18],[0,0,1,0,2,1,1,18],[1,0,0,1,2,1,1,08],[0,0,0,0,2,1,1,18],[0,0,0,0,2,1,1,18],[0,0,0,0,2,1,1,18],[0,0,0,1,2,1,1,18]],
[[1,0,0,0,2,1,1,18],[0,0,0,0,2,1,1,18],[0,0,0,0,2,1,1,18],[0,1,0,0,2,1,1,18],[0,0,0,0,2,1,1,18],[0,0,0,0,2,1,1,18],[0,0,1,0,2,1,1,18],[1,1,0,0,2,1,1,18]]]
#1b
[[[1,1,0,0,2,1,1,18],[0,1,0,0,2,1,1,18],[0,1,0,0,2,1,1,18],[0,1,1,0,2,1,1,18],[1,1,0,0,2,1,1,18],[0,1,0,0,2,1,1,18],[0,1,0,0,2,1,1,18],[0,1,0,0,2,1,1,18]],
[[1,0,0,0,2,1,1,18],[0,0,0,0,2,1,1,18],[0,0,0,0,2,1,1,18],[0,0,0,0,2,1,1,18],[0,0,0,0,2,1,1,18],[0,0,1,1,2,1,1,15],[1,0,0,0,2,1,1,18],[0,0,0,0,2,1,1,18]],
[[1,0,1,0,2,1,1,18],[1,0,0,1,2,1,1,12],[0,0,0,0,2,1,1,18],[0,0,0,0,2,1,1,18],[0,0,0,0,2,1,1,18],[0,1,0,0,2,1,1,18],[0,0,0,0,2,1,1,18],[0,0,0,0,2,1,1,18]],
[[1,0,0,1,2,1,1,18],[0,1,0,0,2,1,1,18],[0,0,0,0,2,1,1,18],[0,0,0,0,2,1,1,18],[0,0,0,0,2,1,1,18],[0,0,0,0,2,1,1,18],[0,0,0,1,2,1,1,18],[0,0,0,0,2,1,1,18]],
[[1,1,0,0,2,1,1,18],[0,0,0,0,2,1,1,18],[0,0,0,0,2,1,1,18],[0,0,0,0,2,1,1,18],[0,0,0,0,2,1,1,18],[0,0,1,0,2,1,1,18],[1,1,0,0,2,1,1,02],[0,0,0,0,2,1,1,18]],
[[1,0,0,0,2,1,1,18],[0,0,0,0,2,1,1,18],[0,0,0,1,2,1,1,18],[0,0,0,0,2,1,1,18],[0,0,0,0,2,1,1,18],[0,0,0,0,2,1,1,18],[0,0,0,0,2,1,1,18],[0,0,0,0,2,1,1,18]],
[[1,0,0,0,2,1,1,18],[0,0,0,0,2,1,1,18],[0,1,1,0,2,1,1,06],[1,0,0,0,2,1,1,18],[0,0,0,0,2,1,1,18],[0,0,0,0,2,1,1,18],[0,0,0,0,2,1,1,18],[0,0,0,1,2,1,1,18]],
[[1,0,0,0,2,1,1,18],[0,0,0,0,2,1,1,18],[0,0,0,0,2,1,1,18],[0,0,0,0,2,1,1,18],[0,0,0,0,2,1,1,18],[0,0,0,0,2,1,1,18],[0,0,1,0,2,1,1,18],[1,1,0,0,2,1,1,18]]]
#1c
[[[1,1,0,0,2,1,1,18],[0,1,0,0,2,1,1,18],[0,1,0,0,2,1,1,18],[0,1,1,0,2,1,1,18],[1,1,0,0,2,1,1,18],[0,1,0,0,2,1,1,18],[0,1,0,0,2,1,1,18],[0,1,0,0,2,1,1,18]],
[[1,0,0,0,2,1,1,18],[0,0,0,0,2,1,1,18],[0,0,0,0,2,1,1,18],[0,0,0,0,2,1,1,18],[0,0,0,0,2,1,1,18],[0,0,0,0,2,1,1,18],[0,0,0,0,2,1,1,18],[0,0,0,0,2,1,1,18]],
[[1,0,0,0,2,1,1,18],[0,0,0,0,2,1,1,18],[0,0,0,0,2,1,1,18],[0,0,0,0,2,1,1,18],[0,0,0,0,2,1,1,18],[0,0,1,1,2,1,1,07],[1,0,0,0,2,1,1,18],[0,0,0,0,2,1,1,18]],
[[1,0,0,0,2,1,1,18],[0,0,0,0,2,1,1,18],[0,0,0,1,2,1,1,18],[0,0,0,0,2,1,1,18],[0,0,0,0,2,1,1,18],[0,1,0,0,2,1,1,18],[0,0,0,0,2,1,1,18],[0,0,0,0,2,1,1,18]],
[[1,0,0,1,2,1,1,18],[0,0,0,0,2,1,1,18],[0,1,1,0,2,1,1,13],[1,0,0,0,2,1,1,18],[0,0,0,0,2,1,1,18],[0,0,0,0,2,1,1,18],[0,0,0,0,2,1,1,18],[0,0,0,0,2,1,1,18]],
[[1,1,0,0,2,1,1,18],[0,0,0,1,2,1,1,18],[0,0,0,0,2,1,1,18],[0,0,0,0,2,1,1,18],[0,0,0,0,2,1,1,18],[0,0,0,0,2,1,1,18],[0,0,1,0,2,1,1,18],[1,0,0,1,2,1,1,10]],
[[1,0,1,0,2,1,1,18],[1,1,0,0,2,1,1,04],[0,0,0,0,2,1,1,18],[0,0,0,0,2,1,1,18],[0,0,0,0,2,1,1,18],[0,0,0,0,2,1,1,18],[0,0,0,0,2,1,1,18],[0,1,0,1,2,1,1,18]],
[[1,0,0,0,2,1,1,18],[0,0,0,0,2,1,1,18],[0,0,0,0,2,1,1,18],[0,0,0,0,2,1,1,18],[0,0,0,0,2,1,1,18],[0,0,0,0,2,1,1,18],[0,0,1,0,2,1,1,18],[1,1,0,0,2,1,1,18]]]
#1d
[[[1,1,0,0,2,1,1,18],[0,1,0,0,2,1,1,18],[0,1,0,0,2,1,1,18],[0,1,1,0,2,1,1,18],[1,1,0,0,2,1,1,18],[0,1,0,0,2,1,1,18],[0,1,0,0,2,1,1,18],[0,1,0,0,2,1,1,18]],
[[1,0,0,0,2,1,1,18],[0,0,0,0,2,1,1,18],[0,0,0,0,2,1,1,18],[0,0,0,0,2,1,1,18],[0,0,0,0,2,1,1,18],[0,0,0,0,2,1,1,18],[1,0,0,1,2,1,1,05],[0,0,0,0,2,1,1,18]],
[[1,0,0,0,2,1,1,18],[0,0,0,0,2,1,1,18],[0,0,0,0,2,1,1,18],[0,0,0,0,2,1,1,18],[0,0,0,0,2,1,1,18],[0,0,0,0,2,1,1,18],[0,0,0,0,2,1,1,18],[0,0,0,0,2,1,1,18]],
[[1,0,0,0,2,1,1,18],[0,1,1,0,2,1,1,01],[0,0,0,0,2,1,1,18],[0,0,0,0,2,1,1,18],[0,0,0,0,2,1,1,18],[0,0,0,1,2,1,1,18],[0,0,0,0,2,1,1,18],[0,0,0,0,2,1,1,18]],
[[1,0,0,0,2,1,1,18],[0,0,0,0,2,1,1,18],[0,0,0,0,2,1,1,18],[0,0,0,0,2,1,1,18],[0,0,1,0,2,1,1,18],[1,1,0,0,2,1,1,16],[0,0,0,0,2,1,1,18],[0,0,0,0,2,1,1,18]],
[[1,0,0,0,2,1,1,18],[0,0,0,0,2,1,1,18],[0,0,1,1,2,1,1,11],[1,0,0,0,2,1,1,18],[0,0,0,0,2,1,1,18],[0,0,0,0,2,1,1,18],[0,0,0,0,2,1,1,18],[0,0,1,1,2,1,1,17]],
[[1,0,0,1,2,1,1,18],[0,0,0,0,2,1,1,18],[0,1,0,0,2,1,1,18],[0,0,0,0,2,1,1,18],[0,0,0,0,2,1,1,18],[0,0,0,0,2,1,1,18],[0,0,0,0,2,1,1,18],[0,0,0,1,2,1,1,18]],
[[1,1,0,0,2,1,1,18],[0,0,0,0,2,1,1,18],[0,0,0,0,2,1,1,18],[0,0,0,0,2,1,1,18],[0,0,0,0,2,1,1,18],[0,0,0,0,2,1,1,18],[0,0,1,0,2,1,1,18],[1,1,0,0,2,1,1,18]]]
#2a
[[[1,1,0,0,2,1,1,18],[0,1,0,0,2,1,1,18],[0,1,0,0,2,1,1,18],[0,1,0,0,2,1,1,18],[0,1,1,0,2,1,1,18],[1,1,0,0,2,1,1,18],[0,1,0,0,2,1,1,18],[0,1,0,0,2,1,1,18]],
[[1,0,0,0,2,1,1,18],[0,0,0,1,2,1,1,18],[0,0,0,0,2,1,1,18],[0,0,0,0,2,1,1,18],[0,0,0,0,2,1,1,18],[0,0,0,0,2,1,1,18],[0,0,1,1,2,1,1,03],[1,0,0,0,2,1,1,18]],
[[1,0,1,0,2,1,1,18],[1,1,0,0,2,1,1,14],[0,0,0,0,2,1,1,18],[0,0,0,0,2,1,1,18],[0,0,0,0,2,1,1,18],[0,0,0,0,2,1,1,18],[0,1,0,0,2,1,1,18],[0,0,0,0,2,1,1,18]],
[[1,0,0,0,2,1,1,18],[0,0,0,0,2,1,1,18],[0,0,0,0,2,1,1,18],[0,0,0,0,2,1,1,18],[0,0,0,0,2,1,1,18],[0,0,0,0,2,1,1,18],[0,0,0,0,2,1,1,18],[0,0,0,0,2,1,1,18]],
[[1,0,0,0,2,1,1,18],[0,0,0,0,2,1,1,18],[0,0,0,0,2,1,1,18],[0,0,0,0,2,1,1,18],[0,0,0,0,2,1,1,18],[0,0,0,0,2,1,1,18],[0,0,0,1,2,1,1,18],[0,0,0,0,2,1,1,18]],
[[1,0,0,1,2,1,1,18],[0,0,0,0,2,1,1,18],[0,0,0,0,2,1,1,18],[0,0,0,0,2,1,1,18],[0,0,0,0,2,1,1,18],[0,0,0,0,2,1,1,18],[0,1,1,0,2,1,1,08],[1,0,0,0,2,1,1,18]],
[[1,1,0,0,2,1,1,18],[0,0,0,0,2,1,1,18],[0,0,1,0,2,1,1,18],[1,0,0,1,2,1,1,09],[0,0,0,0,2,1,1,18],[0,0,0,0,2,1,1,18],[0,0,0,0,2,1,1,18],[0,0,0,1,2,1,1,18]],
[[1,0,0,0,2,1,1,18],[0,0,0,0,2,1,1,18],[0,0,0,0,2,1,1,18],[0,1,0,0,2,1,1,18],[0,0,0,0,2,1,1,18],[0,0,0,0,2,1,1,18],[0,0,1,0,2,1,1,18],[1,1,0,0,2,1,1,18]]]
#2b
[[[1,1,0,0,2,1,1,18],[0,1,0,0,2,1,1,18],[0,1,0,1,2,1,1,18],[0,1,0,0,2,1,1,18],[0,1,1,0,2,1,1,18],[1,1,0,0,2,1,1,18],[0,1,0,0,2,1,1,18],[0,1,0,0,2,1,1,18]],
[[1,0,0,0,2,1,1,18],[0,0,1,0,2,1,1,18],[1,1,0,0,2,1,1,02],[0,0,0,0,2,1,1,18],[0,0,0,0,2,1,1,18],[0,0,0,0,2,1,1,18],[0,0,0,0,2,1,1,18],[0,0,0,0,2,1,1,18]],
[[1,0,0,0,2,1,1,18],[0,0,0,0,2,1,1,18],[0,0,0,0,2,1,1,18],[0,0,0,0,2,1,1,18],[0,0,0,0,2,1,1,18],[0,0,0,0,2,1,1,18],[0,0,0,0,2,1,1,18],[0,0,0,0,2,1,1,18]],
[[1,0,0,0,2,1,1,18],[0,0,0,0,2,1,1,18],[0,0,0,0,2,1,1,18],[0,0,0,0,2,1,1,18],[0,0,0,0,2,1,1,18],[0,0,1,0,2,1,1,18],[1,0,0,1,2,1,1,06],[0,0,0,0,2,1,1,18]],
[[1,0,0,1,2,1,1,18],[0,0,0,0,2,1,1,18],[0,0,0,0,2,1,1,18],[0,0,0,0,2,1,1,18],[0,0,0,1,2,1,1,18],[0,0,0,0,2,1,1,18],[0,1,0,0,2,1,1,18],[0,0,0,0,2,1,1,18]],
[[1,1,0,0,2,1,1,18],[0,0,0,0,2,1,1,18],[0,0,0,0,2,1,1,18],[0,0,0,0,2,1,1,18],[0,1,1,0,2,1,1,12],[1,0,0,0,2,1,1,18],[0,0,0,0,2,1,1,18],[0,0,0,0,2,1,1,18]],
[[1,0,0,0,2,1,1,18],[0,0,1,1,2,1,1,03],[1,0,0,0,2,1,1,18],[0,0,0,0,2,1,1,18],[0,0,0,0,2,1,1,18],[0,0,0,0,2,1,1,18],[0,0,0,0,2,1,1,18],[0,0,0,1,2,1,1,18]],
[[1,0,0,0,2,1,1,18],[0,1,0,0,2,1,1,18],[0,0,0,0,2,1,1,18],[0,0,0,0,2,1,1,18],[0,0,0,0,2,1,1,18],[0,0,0,0,2,1,1,18],[0,0,1,0,2,1,1,18],[1,1,0,0,2,1,1,18]]]
#2c
[[[1,1,0,0,2,1,1,18],[0,1,0,0,2,1,1,18],[0,1,0,0,2,1,1,18],[0,1,1,0,2,1,1,18],[1,1,0,0,2,1,1,18],[0,1,0,0,2,1,1,18],[0,1,0,0,2,1,1,18],[0,1,0,0,2,1,1,18]],
[[1,0,1,0,2,1,1,18],[1,0,0,1,2,1,1,10],[0,0,0,0,2,1,1,18],[0,0,0,0,2,1,1,18],[0,0,0,0,2,1,1,18],[0,0,0,0,2,1,1,18],[0,0,0,1,2,1,1,18],[0,0,0,0,2,1,1,18]],
[[1,0,0,0,2,1,1,18],[0,1,0,0,2,1,1,18],[0,0,0,0,2,1,1,18],[0,0,0,0,2,1,1,18],[0,0,0,0,2,1,1,18],[0,0,0,0,2,1,1,18],[0,1,1,0,2,1,1,13],[1,0,0,0,2,1,1,18]],
[[1,0,0,0,2,1,1,18],[0,0,0,0,2,1,1,18],[0,0,0,0,2,1,1,18],[0,0,0,0,2,1,1,18],[0,0,0,0,2,1,1,18],[0,0,0,0,2,1,1,18],[0,0,0,0,2,1,1,18],[0,0,0,0,2,1,1,18]],
[[1,0,0,0,2,1,1,18],[0,0,0,0,2,1,1,18],[0,0,1,1,2,1,1,07],[1,0,0,0,2,1,1,18],[0,0,0,0,2,1,1,18],[0,0,0,0,2,1,1,18],[0,0,0,0,2,1,1,18],[0,0,0,1,2,1,1,18]],
[[1,0,0,1,2,1,1,18],[0,0,0,0,2,1,1,18],[0,1,0,0,2,1,1,18],[0,0,0,0,2,1,1,18],[0,0,0,0,2,1,1,18],[0,0,0,0,2,1,1,18],[0,0,1,0,2,1,1,18],[1,1,0,0,2,1,1,04]],
[[1,1,0,0,2,1,1,18],[0,0,0,0,2,1,1,18],[0,0,0,0,2,1,1,18],[0,0,0,0,2,1,1,18],[0,0,0,0,2,1,1,18],[0,0,0,0,2,1,1,18],[0,0,0,0,2,1,1,18],[0,0,0,1,2,1,1,18]],
[[1,0,0,0,2,1,1,18],[0,0,0,0,2,1,1,18],[0,0,0,0,2,1,1,18],[0,0,0,0,2,1,1,18],[0,0,0,0,2,1,1,18],[0,0,0,0,2,1,1,18],[0,0,1,0,2,1,1,18],[1,1,0,0,2,1,1,18]]]
#2d
[[[1,1,0,0,2,1,1,18],[0,1,0,0,2,1,1,18],[0,1,0,0,2,1,1,18],[0,1,0,0,2,1,1,18],[0,1,1,0,2,1,1,18],[1,1,0,0,2,1,1,18],[0,1,0,0,2,1,1,18],[0,1,0,0,2,1,1,18]],
[[1,0,0,0,2,1,1,18],[0,0,0,0,2,1,1,18],[0,0,1,1,2,1,1,11],[1,0,0,0,2,1,1,18],[0,0,0,0,2,1,1,18],[0,0,0,0,2,1,1,18],[0,0,0,0,2,1,1,18],[0,0,0,0,2,1,1,18]],
[[1,0,0,0,2,1,1,18],[0,0,0,0,2,1,1,18],[0,1,0,0,2,1,1,18],[0,0,0,0,2,1,1,18],[0,0,0,0,2,1,1,18],[0,0,0,0,2,1,1,18],[0,0,0,0,2,1,1,18],[0,0,0,0,2,1,1,18]],
[[1,0,1,0,2,1,1,18],[1,0,0,1,2,1,1,16],[0,0,0,0,2,1,1,18],[0,0,0,0,2,1,1,18],[0,0,0,0,2,1,1,18],[0,0,0,0,2,1,1,18],[0,0,0,1,2,1,1,18],[0,0,0,0,2,1,1,18]],
[[1,0,0,1,2,1,1,18],[0,1,0,0,2,1,1,18],[0,0,0,0,2,1,1,18],[0,0,0,0,2,1,1,18],[0,0,0,0,2,1,1,18],[0,0,1,0,2,1,1,18],[1,1,0,0,2,1,1,01],[0,0,0,0,2,1,1,18]],
[[1,1,0,0,2,1,1,18],[0,0,0,0,2,1,1,18],[0,0,0,0,2,1,1,18],[0,0,0,0,2,1,1,18],[0,0,0,0,2,1,1,18],[0,0,0,1,2,1,1,18],[0,0,0,0,2,1,1,18],[0,0,0,0,2,1,1,18]],
[[1,0,0,0,2,1,1,18],[0,0,0,0,2,1,1,18],[0,0,0,0,2,1,1,18],[0,0,0,0,2,1,1,18],[0,0,0,0,2,1,1,18],[0,1,1,0,2,1,1,05],[1,0,0,0,2,1,1,18],[0,0,0,1,2,1,1,18]],
[[1,0,0,0,2,1,1,18],[0,0,0,0,2,1,1,18],[0,0,0,0,2,1,1,18],[0,0,1,1,2,1,1,17],[1,0,0,0,2,1,1,18],[0,0,0,0,2,1,1,18],[0,0,1,0,2,1,1,18],[1,1,0,0,2,1,1,18]]]
#3a
[[[1,1,0,0,2,1,1,18],[0,1,1,0,2,1,1,18],[1,1,0,0,2,1,1,18],[0,1,0,1,2,1,1,18],[0,1,0,0,2,1,1,18],[0,1,0,0,2,1,1,18],[0,1,0,0,2,1,1,18],[0,1,0,0,2,1,1,18]],
[[1,0,0,0,2,1,1,18],[0,0,0,0,2,1,1,18],[0,0,1,0,2,1,1,18],[1,1,0,0,2,1,1,14],[0,0,0,0,2,1,1,18],[0,0,0,0,2,1,1,18],[0,0,0,0,2,1,1,18],[0,0,0,0,2,1,1,18]],
[[1,0,0,0,2,1,1,18],[0,0,0,0,2,1,1,18],[0,0,0,0,2,1,1,18],[0,0,0,0,2,1,1,18],[0,0,0,0,2,1,1,18],[0,0,0,0,2,1,1,18],[0,0,0,0,2,1,1,18],[0,0,0,0,2,1,1,18]],
[[1,0,0,0,2,1,1,18],[0,0,0,0,2,1,1,18],[0,0,0,0,2,1,1,18],[0,0,0,0,2,1,1,18],[0,0,0,0,2,1,1,18],[0,0,0,0,2,1,1,18],[0,0,1,1,2,1,1,03],[1,0,0,0,2,1,1,18]],
[[1,0,1,0,2,1,1,18],[1,0,0,1,2,1,1,10],[0,0,0,0,2,1,1,18],[0,0,0,0,2,1,1,18],[0,0,0,0,2,1,1,18],[0,0,0,0,2,1,1,18],[0,1,0,0,2,1,1,18],[0,0,0,0,2,1,1,18]],
[[1,0,0,0,2,1,1,18],[0,1,0,0,2,1,1,18],[0,0,0,0,2,1,1,18],[0,0,0,0,2,1,1,18],[0,0,0,1,2,1,1,18],[0,0,0,0,2,1,1,18],[0,0,0,0,2,1,1,18],[0,0,0,0,2,1,1,18]],
[[1,0,0,1,2,1,1,18],[0,0,0,0,2,1,1,18],[0,0,0,0,2,1,1,18],[0,0,0,0,2,1,1,18],[0,1,1,0,2,1,1,08],[1,0,0,0,2,1,1,18],[0,0,0,0,2,1,1,18],[0,0,0,1,2,1,1,18]],
[[1,1,0,0,2,1,1,18],[0,0,0,0,2,1,1,18],[0,0,0,0,2,1,1,18],[0,0,0,0,2,1,1,18],[0,0,0,0,2,1,1,18],[0,0,0,0,2,1,1,18],[0,0,1,0,2,1,1,18],[1,1,0,0,2,1,1,18]]]
#3b
[[[1,1,0,0,2,1,1,18],[0,1,0,0,2,1,1,18],[0,1,0,0,2,1,1,18],[0,1,0,0,2,1,1,18],[0,1,0,0,2,1,1,18],[0,1,1,0,2,1,1,18],[1,1,0,0,2,1,1,18],[0,1,0,0,2,1,1,18]],
[[1,0,0,0,2,1,1,18],[0,0,0,0,2,1,1,18],[0,0,0,0,2,1,1,18],[0,0,0,1,2,1,1,18],[0,0,0,0,2,1,1,18],[0,0,0,0,2,1,1,18],[0,0,0,0,2,1,1,18],[0,0,0,0,2,1,1,18]],
[[1,0,0,0,2,1,1,18],[0,0,0,0,2,1,1,18],[0,0,1,0,2,1,1,18],[1,1,0,0,2,1,1,02],[0,0,0,0,2,1,1,18],[0,0,0,0,2,1,1,18],[0,0,0,0,2,1,1,18],[0,0,0,0,2,1,1,18]],
[[1,0,0,1,2,1,1,18],[0,0,0,0,2,1,1,18],[0,0,0,1,2,1,1,18],[0,0,0,0,2,1,1,18],[0,0,1,0,2,1,1,18],[1,0,0,1,2,1,1,06],[0,0,0,0,2,1,1,18],[0,0,0,0,2,1,1,18]],
[[1,1,0,0,2,1,1,18],[0,0,0,0,2,1,1,18],[0,1,1,0,2,1,1,12],[0,0,0,0,2,1,1,18],[0,0,0,0,2,1,1,18],[0,1,0,0,2,1,1,18],[0,0,0,0,2,1,1,18],[0,0,0,0,2,1,1,18]],
[[1,0,0,0,2,1,1,18],[0,0,0,0,2,1,1,18],[0,0,0,0,2,1,1,18],[0,0,0,0,2,1,1,18],[0,0,1,1,2,1,1,15],[1,0,0,0,2,1,1,18],[0,0,0,0,2,1,1,18],[0,0,0,0,2,1,1,18]],
[[1,0,0,0,2,1,1,18],[0,0,0,0,2,1,1,18],[0,0,0,0,2,1,1,18],[0,0,0,0,2,1,1,18],[0,1,0,0,2,1,1,18],[0,0,0,0,2,1,1,18],[0,0,0,0,2,1,1,18],[0,0,0,1,2,1,1,18]],
[[1,0,0,0,2,1,1,18],[0,0,0,0,2,1,1,18],[0,0,0,0,2,1,1,18],[0,0,0,0,2,1,1,18],[0,0,0,0,2,1,1,18],[0,0,0,0,2,1,1,18],[0,0,1,0,2,1,1,18],[1,1,0,0,2,1,1,18]]]
#3c
[[[1,1,0,0,2,1,1,18],[0,1,1,0,2,1,1,18],[1,1,0,0,2,1,1,18],[0,1,0,0,2,1,1,18],[0,1,0,1,2,1,1,18],[0,1,0,0,2,1,1,18],[0,1,0,0,2,1,1,18],[0,1,0,0,2,1,1,18]],
[[1,0,0,0,2,1,1,18],[0,0,0,0,2,1,1,18],[0,0,0,0,2,1,1,18],[0,0,0,0,2,1,1,18],[0,1,1,0,2,1,1,13],[0,0,0,0,2,1,1,18],[0,0,0,0,2,1,1,18],[0,0,0,0,2,1,1,18]],
[[1,0,0,0,2,1,1,18],[0,0,0,0,2,1,1,18],[0,0,0,0,2,1,1,18],[0,0,0,0,2,1,1,18],[0,0,0,0,2,1,1,18],[0,0,0,0,2,1,1,18],[0,0,0,0,2,1,1,18],[0,0,0,0,2,1,1,18]],
[[1,0,1,0,2,1,1,18],[1,0,0,1,2,1,1,10],[0,0,0,0,2,1,1,18],[0,0,0,0,2,1,1,18],[0,0,0,0,2,1,1,18],[0,0,0,0,2,1,1,18],[0,0,0,0,2,1,1,18],[0,0,0,0,2,1,1,18]],
[[1,0,0,0,2,1,1,18],[0,1,0,0,2,1,1,18],[0,0,0,0,2,1,1,18],[0,0,0,0,2,1,1,18],[0,0,0,0,2,1,1,18],[0,0,0,1,2,1,1,18],[0,0,0,0,2,1,1,18],[0,0,0,0,2,1,1,18]],
[[1,0,0,1,2,1,1,18],[0,0,0,0,2,1,1,18],[0,0,0,0,2,1,1,18],[0,0,0,0,2,1,1,18],[0,0,1,0,2,1,1,18],[1,1,0,0,2,1,1,04],[0,0,0,0,2,1,1,18],[0,0,0,0,2,1,1,18]],
[[1,1,0,0,2,1,1,18],[0,0,0,0,2,1,1,18],[0,0,0,0,2,1,1,18],[0,0,1,1,2,1,1,07],[1,0,0,0,2,1,1,18],[0,0,0,0,2,1,1,18],[0,0,0,0,2,1,1,18],[0,0,0,1,2,1,1,18]],
[[1,0,0,0,2,1,1,18],[0,0,0,0,2,1,1,18],[0,0,0,0,2,1,1,18],[0,1,0,0,2,1,1,18],[0,0,0,0,2,1,1,18],[0,0,0,0,2,1,1,18],[0,0,1,0,2,1,1,18],[1,1,0,0,2,1,1,18]]]
#3d
[[[1,1,0,0,2,1,1,18],[0,1,0,0,2,1,1,18],[0,1,1,0,2,1,1,18],[1,1,0,0,2,1,1,18],[0,1,0,0,2,1,1,18],[0,1,0,0,2,1,1,18],[0,1,0,0,2,1,1,18],[0,1,0,0,2,1,1,18]],
[[1,0,0,0,2,1,1,18],[0,0,0,0,2,1,1,18],[0,0,0,0,2,1,1,18],[0,0,0,0,2,1,1,18],[0,0,1,0,2,1,1,18],[1,0,0,1,2,1,1,05],[0,0,0,0,2,1,1,18],[0,0,0,0,2,1,1,18]],
[[1,0,0,0,2,1,1,18],[0,0,0,0,2,1,1,18],[0,0,0,0,2,1,1,18],[0,0,0,0,2,1,1,18],[0,0,0,0,2,1,1,18],[0,1,0,0,2,1,1,18],[0,0,0,0,2,1,1,18],[0,0,1,1,2,1,1,17]],
[[1,0,0,1,2,1,1,18],[0,0,0,0,2,1,1,18],[0,0,0,0,2,1,1,18],[0,0,0,0,2,1,1,18],[0,0,0,0,2,1,1,18],[0,0,0,0,2,1,1,18],[0,0,0,0,2,1,1,18],[0,0,0,0,2,1,1,18]],
[[1,1,0,0,2,1,1,18],[0,0,0,0,2,1,1,18],[0,0,1,1,2,1,1,11],[1,0,0,0,2,1,1,18],[0,0,0,0,2,1,1,18],[0,0,0,1,2,1,1,18],[0,0,0,0,2,1,1,18],[0,0,0,0,2,1,1,18]],
[[1,0,0,0,2,1,1,18],[0,0,0,1,2,1,1,18],[0,1,0,0,2,1,1,18],[0,0,0,0,2,1,1,18],[0,0,1,0,2,1,1,18],[1,1,0,0,2,1,1,16],[0,0,0,0,2,1,1,18],[0,0,0,0,2,1,1,18]],
[[1,0,0,0,2,1,1,18],[0,1,1,0,2,1,1,01],[1,0,0,0,2,1,1,18],[0,0,0,0,2,1,1,18],[0,0,0,0,2,1,1,18],[0,0,0,0,2,1,1,18],[0,0,0,0,2,1,1,18],[0,0,0,1,2,1,1,18]],
[[1,0,0,0,2,1,1,18],[0,0,0,0,2,1,1,18],[0,0,0,0,2,1,1,18],[0,0,0,0,2,1,1,18],[0,0,0,0,2,1,1,18],[0,0,0,0,2,1,1,18],[0,0,1,0,2,1,1,18],[1,1,0,0,2,1,1,18]]]
#4a
[[[1,1,0,0,2,1,1,18],[0,1,0,0,2,1,1,18],[0,1,0,0,2,1,1,18],[0,1,0,0,2,1,1,18],[0,1,0,0,2,1,1,18],[0,1,1,0,2,1,1,18],[1,1,0,0,2,1,1,18],[0,1,0,0,2,1,1,18]],
[[1,0,0,0,2,1,1,18],[0,0,0,0,2,1,1,18],[0,0,0,0,2,1,1,18],[0,0,0,0,2,1,1,18],[0,0,0,0,1,1,2,18],[0,0,0,0,2,1,1,18],[0,0,0,0,2,1,1,18],[0,0,0,0,2,1,1,18]],
[[1,0,0,0,2,1,1,18],[0,0,0,0,2,1,1,18],[0,0,0,0,2,1,1,18],[0,0,0,0,2,1,1,18],[0,0,0,0,2,1,1,18],[0,0,0,0,2,1,1,18],[0,0,0,0,2,1,1,18],[0,0,0,0,2,1,1,18]],
[[1,0,1,0,2,1,1,18],[1,1,0,0,2,1,1,09],[0,0,0,0,2,1,1,18],[0,0,0,0,2,1,1,18],[0,0,0,0,2,1,1,18],[0,0,0,0,2,1,1,18],[0,0,0,0,2,1,1,18],[0,0,0,0,2,1,1,18]],
[[1,0,0,0,2,1,1,18],[0,0,0,0,2,1,1,18],[0,0,0,0,2,1,1,18],[0,0,0,0,2,1,1,18],[0,0,0,0,2,1,1,18],[0,0,0,0,2,1,1,18],[0,0,1,1,2,1,1,03],[1,0,0,0,2,1,1,18]],
[[1,0,0,1,2,1,1,18],[0,0,0,0,2,1,1,18],[0,0,0,1,2,1,1,18],[0,0,0,0,2,1,1,18],[0,0,0,0,2,1,1,18],[0,0,0,0,2,1,1,18],[0,1,0,0,2,1,1,18],[0,0,0,0,2,1,1,18]],
[[1,1,0,0,2,1,1,18],[0,0,0,0,2,1,1,18],[0,1,1,0,2,1,1,14],[1,0,0,1,2,1,1,08],[0,0,0,0,2,1,1,18],[0,0,0,0,2,1,1,18],[0,0,0,0,2,1,1,18],[0,0,0,1,2,1,1,18]],
[[1,0,0,0,2,1,1,18],[0,0,0,0,2,1,1,18],[0,0,0,0,2,1,1,18],[0,1,0,0,2,1,1,18],[0,0,0,0,2,1,1,18],[0,0,0,0,0,1,4,18],[0,0,1,0,2,1,1,18],[1,1,0,0,2,1,1,18]]]
#4b
[[[1,1,0,0,2,1,1,18],[0,1,0,0,2,1,1,18],[0,1,1,0,2,1,1,18],[1,1,0,0,2,1,1,18],[0,1,0,0,2,1,1,18],[0,1,0,0,2,1,1,18],[0,1,0,0,2,1,1,18],[0,1,0,0,2,1,1,18]],
[[1,0,0,0,2,1,1,18],[0,0,0,0,2,1,1,18],[0,0,0,0,1,1,1,18],[0,0,0,0,2,1,1,18],[0,0,0,0,2,1,1,18],[0,0,0,0,2,1,1,18],[0,0,0,1,2,1,1,18],[0,0,0,0,2,1,1,18]],
[[1,0,0,0,2,1,1,18],[0,0,0,0,2,1,1,18],[0,0,0,0,2,1,1,18],[0,0,0,0,2,1,1,18],[0,0,0,0,2,1,1,18],[0,0,1,1,2,1,1,15],[1,1,0,0,2,1,1,02],[0,0,0,0,2,1,1,18]],
[[1,0,0,0,2,1,1,18],[0,0,0,0,2,1,1,18],[0,0,0,0,2,1,1,18],[0,0,0,0,2,1,1,18],[0,0,0,0,2,1,1,18],[0,1,0,0,2,1,1,18],[0,0,0,0,2,1,1,18],[0,0,0,0,2,1,1,18]],
[[1,0,0,0,2,1,1,18],[0,0,0,0,2,1,1,18],[0,0,0,0,2,1,1,18],[0,0,0,0,2,1,1,18],[0,0,0,0,2,1,1,18],[0,0,0,0,2,1,1,18],[0,0,0,0,2,1,1,18],[0,0,0,0,0,3,1,18]],
[[1,0,1,0,2,1,1,18],[1,0,0,1,2,1,1,12],[0,0,0,0,2,1,1,18],[0,0,0,0,2,1,1,18],[0,0,0,0,2,1,1,18],[0,0,0,0,2,1,1,18],[0,0,0,0,2,1,1,18],[0,0,0,0,2,1,1,18]],
[[1,0,0,1,2,1,1,18],[0,1,0,0,2,1,1,18],[0,0,0,0,2,1,1,18],[0,0,0,0,2,1,1,18],[0,0,0,1,2,1,1,18],[0,0,0,0,2,1,1,18],[0,0,0,0,2,1,1,18],[0,0,0,1,2,1,1,18]],
[[1,1,0,0,2,1,1,18],[0,0,0,0,2,1,1,18],[0,0,0,0,2,1,1,18],[0,0,0,0,2,1,1,18],[0,1,1,0,2,1,1,06],[1,0,0,0,2,1,1,18],[0,0,1,0,2,1,1,18],[1,1,0,0,2,1,1,18]]]
#4c
[[[1,1,0,0,2,1,1,18],[0,1,0,0,2,1,1,18],[0,1,0,0,2,1,1,18],[0,1,0,0,2,1,1,18],[0,1,1,0,2,1,1,18],[1,1,0,0,2,1,1,18],[0,1,0,0,2,1,1,18],[0,1,0,0,2,1,1,18]],
[[1,0,0,0,2,1,1,18],[0,0,0,0,2,1,1,18],[0,0,0,0,2,1,1,18],[0,0,0,0,2,1,1,18],[0,0,0,0,0,1,1,18],[0,0,0,0,2,1,1,18],[0,0,0,0,2,1,1,18],[0,0,0,0,2,1,1,18]],
[[1,0,0,1,2,1,1,18],[0,0,0,0,2,1,1,18],[0,0,0,0,2,1,1,18],[0,0,0,0,2,1,1,18],[0,0,0,0,2,1,1,18],[0,0,0,0,2,1,1,18],[0,0,1,1,2,1,1,07],[1,0,0,0,2,1,1,18]],
[[1,1,0,0,2,1,1,18],[0,0,0,0,2,1,1,18],[0,0,0,1,2,1,1,18],[0,0,0,0,2,1,1,18],[0,0,0,0,2,1,1,18],[0,0,0,0,2,1,1,18],[0,1,0,0,0,1,4,18],[0,0,0,0,2,1,1,18]],
[[1,0,0,0,2,1,1,18],[0,0,0,0,2,1,1,18],[0,1,1,0,2,1,1,13],[1,0,0,1,2,1,1,10],[0,0,0,0,2,1,1,18],[0,0,0,0,2,1,1,18],[0,0,0,0,2,1,1,18],[0,0,0,0,2,1,1,18]],
[[1,0,0,0,2,1,1,18],[0,0,0,0,2,1,1,18],[0,0,0,0,2,1,1,18],[0,1,0,0,2,1,1,18],[0,0,0,0,2,1,1,18],[0,0,0,1,2,1,1,18],[0,0,0,0,2,1,1,18],[0,0,0,0,2,1,1,18]],
[[1,0,0,0,2,1,1,18],[0,0,0,0,2,1,1,18],[0,0,0,0,2,1,1,18],[0,0,0,0,2,1,1,18],[0,0,1,0,2,1,1,18],[1,1,0,0,2,1,1,04],[0,0,0,0,2,1,1,18],[0,0,0,1,2,1,1,18]],
[[1,0,0,0,2,1,1,18],[0,0,0,0,2,1,1,18],[0,0,0,0,2,1,1,18],[0,0,0,0,2,1,1,18],[0,0,0,0,2,1,1,18],[0,0,0,0,2,1,1,18],[0,0,1,0,2,1,1,18],[1,1,0,0,2,1,1,18]]]
#4d
[[[1,1,0,0,2,1,1,18],[0,1,0,0,2,1,1,18],[0,1,0,0,2,1,1,18],[0,1,0,0,2,1,1,18],[0,1,1,0,2,1,1,18],[1,1,0,0,2,1,1,18],[0,1,0,0,2,1,1,18],[0,1,0,0,2,1,1,18]],
[[1,0,0,0,2,1,1,18],[0,0,0,0,2,1,1,18],[0,0,0,0,0,1,3,18],[0,0,0,0,2,1,1,18],[0,0,0,0,2,1,1,18],[0,0,0,0,2,1,1,18],[0,0,0,1,2,1,1,18],[0,0,0,0,2,1,1,18]],
[[1,0,0,0,2,1,1,18],[0,0,0,0,2,1,1,18],[0,0,0,1,2,1,1,18],[0,0,0,0,2,1,1,18],[0,0,0,0,2,1,1,18],[0,0,1,0,2,1,1,18],[1,1,0,0,2,1,1,01],[0,0,0,0,2,1,1,18]],
[[1,0,0,0,2,1,1,18],[0,0,0,0,2,1,1,18],[0,1,1,0,2,1,1,05],[1,0,0,1,2,1,1,16],[0,0,0,0,2,1,1,18],[0,0,0,0,2,1,1,18],[0,0,0,0,2,1,1,18],[0,0,0,0,2,1,1,18]],
[[1,0,0,0,2,1,1,18],[0,0,0,0,2,1,1,18],[0,0,0,0,2,1,1,18],[0,1,0,0,2,1,1,18],[0,0,0,0,2,1,1,18],[0,0,0,0,2,1,1,18],[0,0,0,0,2,1,1,18],[0,0,0,0,2,1,1,18]],
[[1,0,0,0,2,1,1,18],[0,0,1,1,2,1,1,11],[1,0,0,0,2,1,1,18],[0,0,0,0,2,1,1,18],[0,0,0,0,2,1,1,18],[0,0,0,0,2,1,1,18],[0,0,0,0,2,1,1,18],[0,0,0,0,2,1,1,18]],
[[1,0,0,1,2,1,1,18],[0,1,0,0,2,1,1,18],[0,0,0,0,0,1,2,18],[0,0,0,0,2,1,1,18],[0,0,0,0,2,1,1,18],[0,0,0,0,2,1,1,18],[0,0,0,0,2,1,1,18],[0,0,0,1,2,1,1,18]],
[[1,1,0,0,2,1,1,18],[0,0,0,0,2,1,1,18],[0,0,0,0,2,1,1,18],[0,0,0,0,2,1,1,18],[0,0,0,0,2,1,1,18],[0,0,1,1,2,1,1,17],[1,0,1,0,2,1,1,18],[1,1,0,0,2,1,1,18]]]





















  
        [[[1,1,0,0],[0,1,1,0],[1,1,0,0],[0,1,0,0],[0,1,0,1],[0,1,0,0],[0,1,0,0],[0,1,0,0]],
        [[1,0,0,0],[0,0,0,1],[0,0,0,0],[0,0,1,0],[1,1,0,0],[0,0,0,0],[0,0,0,0],[0,0,0,0]],
        [[1,0,0,0],[0,1,1,0],[1,0,0,0],[0,0,0,0],[0,0,0,0],[0,0,0,0],[0,0,0,0],[0,0,0,0]],
        [[1,0,0,0],[0,0,0,0],[0,0,0,0],[0,0,0,0],[0,0,0,0],[0,0,0,0],[0,0,1,1],[1,0,0,0]],
        [[1,0,0,0],[0,0,0,0],[0,0,0,0],[0,0,0,0],[0,0,0,0],[0,0,0,0],[0,1,0,0],[0,0,0,0]],
        [[1,0,0,1],[0,0,0,0],[0,0,0,0],[0,0,0,0],[0,0,0,0],[0,0,0,0],[0,0,0,0],[0,0,0,0]],
        [[1,1,0,0],[0,0,0,0],[0,0,1,0],[1,0,0,1],[0,0,0,0],[0,0,0,0],[0,0,0,0],[0,0,0,1]],
        [[1,0,0,0],[0,0,0,0],[0,0,0,0],[0,1,0,0],[0,0,0,0],[0,0,0,0],[0,0,1,0],[1,1,0,0]]]